22 22 false 0 8 19 8
██████████████████  ████████████████████████
██          ██              ██            ██
██  ██  ██  ██  ██  ██  ██  ██  ██  ██  ████
██                                        ██
██  ██  ██████████  ██  ██  ██  ██  ██  ████
██              ██                        ██
██  ██  ██  ██  ██  ██  ██  ██  ██████  ████
██                                  ██    ██
██  ██  ██  ██  ██  ██  ██  ██  ██  ██  ████
██          ██                            ██
██  ██  ██  ██  ██  ██  ██  ██  ██  ██  ████
██              ██      ██                ██
██  ██  ██████  ██  ██  ██  ██  ██  ██  ████
██                                        ██
██  ██  ██  ██  ██  ██████  ██  ██  ██  ████
██      ██          ██  ██      ██  ██    ██
██  ██  ██████  ██  ██  ██████  ██  ██  ████
██                                        ██
██  ██  ██  ██  ██  ██  ██  ██  ██  ██  ████
██                                        ██
██  ██  ██  ██  ██  ██  ██  ██  ██  ██  ████
██████████████████  ████████████████████████