15 15 true 2 0 6 12
██████████████████████████████
██  ██                      ██
██  ██  ██  ██████████  ██  ██
                            ██
██  ██████████████  ██████████
██          ██  ██          ██
██  ██  ██  ██  ██  ██████  ██
██              ██  ██        
██  ██  ██  ██  ██  ██  ██  ██
██  ██  ██  ██      ██      ██
██████  ██  ██  ██  ██  ██  ██
██  ██      ██              ██
██  ██████  ██  ██  ██████  ██
██          ██  ██  ██      ██
██████████████████████████████